{
	"data":
		[[02,02,02,02,02,02,02,02,02,02,02,02,02,02,02,02,02,02,02,02,02,02,02,02,02,02,02,02,02,02,02,02,02,2],
		 [02,01,00,14,15,00,01,01,00,00,00,00,01,02,02,02,02,02,02,02,02,01,01,01,01,01,01,01,01,01,01,01,01,2],
		 [02,01,00,16,17,00,01,01,00,07,07,00,01,02,02,02,02,02,02,02,02,01,00,00,00,00,00,00,00,00,00,00,01,2],
		 [02,01,00,00,00,00,01,01,00,07,07,00,01,02,07,07,00,01,01,01,02,01,00,07,07,07,07,08,09,08,09,00,01,2],
		 [02,01,01,01,01,01,01,01,00,00,00,00,01,00,00,00,00,01,01,01,00,01,00,07,07,08,09,10,11,10,11,00,01,2],
		 [02,01,01,01,01,01,01,01,01,01,01,01,01,00,01,01,01,01,01,01,00,01,00,07,07,10,11,08,09,00,07,00,01,2],
		 [02,01,00,00,00,00,01,01,01,01,01,01,01,02,01,01,01,01,01,07,02,01,00,07,07,07,00,10,11,07,07,00,01,2],
		 [02,01,00,08,09,00,01,01,01,01,01,01,01,02,02,02,02,02,02,02,02,01,00,00,00,00,00,00,00,00,00,00,01,2],
		 [02,01,00,10,11,00,01,01,01,01,01,01,01,02,02,02,02,02,02,02,02,01,01,01,01,01,01,01,01,01,01,01,01,2],
		 [02,02,02,02,02,02,00,00,02,02,02,02,02,02,20,13,13,13,06,20,02,02,02,02,02,02,00,00,02,02,02,02,02,2],
		 [02,01,01,01,01,01,01,01,01,01,01,01,01,01,18,00,00,00,00,19,01,00,14,15,00,01,01,01,01,01,01,01,01,2],
		 [02,01,01,01,01,01,01,01,01,00,00,00,00,01,01,00,00,00,00,01,01,00,16,17,00,01,01,01,01,01,01,01,01,2],
		 [02,01,01,01,01,01,01,01,01,00,14,15,00,01,01,00,00,00,00,01,01,00,00,00,00,01,01,01,01,01,01,01,01,2],
		 [02,01,01,01,01,01,01,01,01,00,16,17,00,01,18,00,00,00,00,19,01,01,01,01,01,01,01,01,01,01,01,01,01,2],
		 [02,02,02,02,02,02,00,00,02,02,02,02,02,02,20,12,05,12,12,20,02,02,02,02,02,02,00,00,02,02,02,02,02,2],
		 [02,01,01,01,01,01,01,01,01,01,01,00,07,02,02,02,02,02,02,02,02,01,00,14,15,00,01,01,01,01,01,01,01,2],
		 [02,01,01,01,01,01,01,01,01,01,01,00,00,02,02,02,02,02,02,02,02,01,00,16,17,00,01,01,01,01,01,01,01,2],
		 [02,01,01,01,01,01,01,01,01,01,01,01,01,02,01,01,01,01,01,01,02,01,00,00,00,00,01,01,01,01,01,01,01,2],
		 [02,01,01,01,01,01,01,01,01,01,01,01,01,00,01,01,01,01,01,01,00,01,01,01,01,01,01,01,00,00,00,00,01,2],
		 [02,00,00,00,00,00,00,00,00,01,01,01,01,00,01,01,01,01,01,01,00,01,01,01,01,01,01,01,00,07,07,00,01,2],
		 [02,07,07,07,07,07,07,07,00,01,01,01,01,02,01,01,01,01,01,01,02,01,00,00,00,00,01,01,00,07,07,00,01,2],
		 [02,08,09,08,09,08,09,07,00,00,01,01,01,02,02,02,02,02,02,02,02,01,00,08,09,00,01,01,00,00,00,00,01,2],
		 [02,10,11,10,11,10,11,07,00,01,01,01,01,02,02,02,02,02,02,02,02,01,00,10,11,00,01,01,01,01,01,01,01,2],
		 [02,02,02,02,02,02,02,02,02,02,02,02,02,02,02,02,02,02,02,02,02,02,02,02,02,02,02,02,02,02,02,02,02,2]],
	"warps":
		[
		 ],
	"zombies":
		[
		 ],
	"lights":
		[{"x":100,"y":80,"color":"0x888888","radius":100},
		 {"x":124,"y":80,"color":"0x888888","radius":100},
		 {"x":100,"y":304,"color":"0x888888","radius":100},
		 {"x":124,"y":304,"color":"0x888888","radius":100},
		 {"x":420,"y":304,"color":"0x888888","radius":100},
		 {"x":444,"y":304,"color":"0x888888","radius":100}
		 ],
	"width": 28,
	"start":{"x":120,"y":100},
	"height": 24,
	"tilesize": 16
}